ticker,2018,2019,2020,2021,9999
35G.SG,0,0,0,2,2
7XY,0,0,0,1,1
A,0,0,1,2,3
AA,0,1,1,0,2
AAGIY,0,3,4,5,12
AAIGF,0,0,0,1,1
AAL,0,0,18,13,31
AAN,0,0,2,0,2
AAPL,0,16,96,49,161
AAPl,0,0,0,4,4
AAVMY,0,0,2,0,2
AAWW,0,1,0,0,1
AAl,0,0,0,1,1
AB,0,0,1,2,3
ABALX,0,0,1,0,1
ABB,0,0,4,4,8
ABBV,0,2,11,10,23
ABC,0,0,0,2,2
ABCB,0,0,4,0,4
ABEV,0,2,4,1,7
ABM,0,3,0,0,3
ABMD,0,1,8,0,9
ABNB,0,0,0,4,4
ABT,0,1,17,9,27
ACAD,0,0,1,0,1
ACB,0,0,1,1,2
ACCYY,0,0,1,0,1
ACGL,0,0,1,5,6
ACHC,0,0,0,1,1
ACI,0,0,3,0,3
ACIW,0,0,2,0,2
ACM,0,0,1,0,1
ACN,0,2,26,21,49
ACSAY,0,0,1,0,1
ACST,0,0,0,1,1
AD,0,0,1,0,1
ADA-USD,0,0,0,4,4
ADBE,0,1,12,19,32
ADC,0,0,3,0,3
ADDDYY,0,0,0,1,1
ADDYY,0,2,2,2,6
ADI,0,0,1,1,2
ADM,0,0,0,2,2
ADP,0,1,1,0,2
ADS,0,1,4,1,6
ADSK,0,1,2,4,7
ADTN,0,0,1,0,1
ADUS,0,1,0,0,1
ADYEY,0,0,3,2,5
AEG,0,0,1,0,1
AEIS,0,0,0,3,3
AEP,0,0,7,3,10
AER,0,0,1,0,1
AESE,0,0,0,1,1
AFL,0,0,3,1,4
AFRM,0,0,0,3,3
AFTPY,0,0,1,0,1
AGCO,0,1,0,2,3
AGESY,0,0,2,0,2
AGN,0,3,6,0,9
AGO,0,1,0,0,1
AGR,0,0,1,2,3
AHCO,0,0,0,8,8
AHEXY,0,0,1,0,1
AHKSY,0,0,1,0,1
AHT,0,0,1,0,1
AI,0,0,0,3,3
AIG,0,0,8,4,12
AIMC,0,1,1,0,2
AIO,0,0,0,1,1
AIQUY,0,3,3,1,7
AIR,0,0,1,0,1
AIT,0,0,2,0,2
AIV,0,2,0,0,2
AIVSX,0,0,0,1,1
AIZ,0,1,0,0,1
AJG,0,0,1,1,2
AKAM,0,0,5,2,7
AL,0,0,0,1,1
ALB,0,1,0,4,5
ALC,0,0,5,1,6
ALFVY,0,1,3,1,5
ALFY,0,0,0,1,1
ALGM,0,0,0,1,1
ALGN,0,0,7,1,8
ALGT,0,0,3,1,4
ALIZY,0,0,0,4,4
ALK,0,2,2,1,5
ALL,0,0,1,0,1
ALLE,0,4,0,0,4
ALLY,0,0,5,3,8
ALNY,0,0,2,0,2
ALPMY,0,0,1,0,1
ALXN,0,0,11,3,14
ALb,0,0,0,1,1
AM,0,0,18,21,39
AMADY,0,0,4,0,4
AMAT,0,0,5,6,11
AMBA,0,3,0,0,3
AMCX,0,1,2,0,3
AMD,0,2,9,11,22
AME,0,0,1,0,1
AMED,0,2,1,0,3
AMG,0,0,2,0,2
AMGN,0,0,9,6,15
AMH,0,2,0,0,2
AMJ,0,1,0,1,2
AMKBY,0,0,2,0,2
AMN,0,0,13,0,13
AMP,0,0,3,0,3
AMRC,0,0,7,6,13
AMT,0,1,6,5,12
AMTD,0,0,5,0,5
AMTX,0,0,0,6,6
AMZA,0,0,1,1,2
AMZN,0,4,49,40,93
ANET,0,0,3,0,3
ANIK,0,3,3,0,6
ANSS,0,0,1,0,1
ANTM,0,1,8,4,13
ANWPX,0,0,0,1,1
ANY,0,0,1,0,1
ANZBY,0,0,2,0,2
AOBC,0,1,0,0,1
AON,0,0,5,8,13
AOS,0,3,1,0,4
AOSL,0,0,0,1,1
APC,0,2,0,0,2
APCD,0,0,0,3,3
APD,0,0,10,11,21
APEN,0,0,1,0,1
APH,0,1,2,0,3
APHA,0,0,1,1,2
APLE,0,3,0,0,3
APNHY,0,1,0,0,1
APO,0,0,1,0,1
APPAD,0,0,1,1,2
APPL,0,0,5,4,9
APTV,0,0,3,1,4
AQB,0,0,0,1,1
AQUA,0,0,3,2,5
ARCB,0,0,0,1,1
ARCC,0,0,2,2,4
ARE,0,0,2,0,2
ARI,0,2,0,0,2
ARKG,0,0,1,1,2
ARKK,0,0,1,1,2
ARMK,0,0,3,1,4
ARNA,0,0,1,1,2
ARNC,0,0,2,0,2
AROC,0,0,2,0,2
AROW,0,0,1,0,1
ARR,0,1,0,0,1
ARW,0,0,0,1,1
ASGN,0,0,2,0,2
ASMB,0,0,1,1,2
ASML,0,0,4,7,11
ASXC,0,0,0,2,2
ATASY,0,0,3,0,3
ATH,0,0,0,1,1
ATLKY,0,1,3,1,5
ATO,0,0,3,2,5
ATRC,0,0,3,1,4
ATVI,0,1,11,5,17
AUY,0,0,0,1,1
AVB,0,0,2,1,3
AVGO,0,3,2,7,12
AVLR,0,0,1,0,1
AVNS,0,0,1,0,1
AVNT,0,0,1,0,1
AVT,0,0,1,0,1
AVTR,0,0,1,0,1
AVVIY,0,0,1,0,1
AVY,0,4,3,2,9
AVYA,0,0,1,2,3
AWI,0,1,0,2,3
AWK,0,0,2,2,4
AXGN,0,2,0,0,2
AXP,0,1,8,13,22
AXTA,0,0,0,1,1
AY,0,0,0,3,3
AYI,0,2,1,0,3
AZEK,0,0,1,2,3
AZN,0,0,2,6,8
AZO,0,1,10,4,15
AZSEY,0,3,0,0,3
AZTA,0,0,0,2,2
AlGM,0,0,0,1,1
BA,0,0,22,9,31
BABA,0,4,31,32,67
BAC,0,1,14,15,30
BAC$K,0,0,3,0,3
BAESY,0,0,1,1,2
BAFWX,0,0,0,4,4
BAH,0,0,2,3,5
BALY,0,0,0,2,2
BAM,0,0,0,1,1
BAMXY,0,1,0,0,1
BAND,0,0,1,0,1
BASFY,0,0,1,0,1
BAT-USD,0,0,0,1,1
BATRA,0,0,1,0,1
BAX,0,0,6,4,10
BAYRY,0,2,1,0,3
BBBY,0,0,1,0,1
BBCBX,0,0,0,1,1
BBGLX,0,0,0,1,1
BBH,0,0,0,2,2
BBNTX,0,0,2,0,2
BBTBX,0,0,0,2,2
BBVA,0,3,6,2,11
BBVLX,0,0,0,1,1
BBVSX,0,0,0,1,1
BBY,0,0,0,6,6
BCE,0,0,0,1,1
BCPC,0,1,1,1,3
BCS,0,0,2,0,2
BDC,0,0,2,0,2
BDN,0,2,1,0,3
BDX,0,3,20,4,27
BE,0,0,4,5,9
BECN,0,0,1,0,1
BEEM,0,0,2,0,2
BEN,0,1,9,1,11
BEP,0,0,0,2,2
BERY,0,2,1,1,4
BF.B,0,3,0,0,3
BFAM,0,0,2,1,3
BG,0,0,1,0,1
BGFV,0,0,3,0,3
BGG,0,0,1,0,1
BGNE,0,0,1,0,1
BGSIX,0,0,1,0,1
BH,0,2,0,0,2
BHC,0,0,3,0,3
BHF,0,0,1,0,1
BHI,0,0,0,1,1
BHKLY,0,0,1,0,1
BHP,0,0,0,6,6
BHPLF,0,0,0,1,1
BIAWX,0,0,0,2,2
BIDU,0,3,9,0,12
BIF,0,1,2,0,3
BIG,0,1,0,0,1
BIIB,0,1,6,6,13
BIO,0,0,3,1,4
BIP,0,0,3,1,4
BIPC,0,0,4,0,4
BJ,0,0,0,1,1
BK,0,3,4,2,9
BKEP,0,0,1,5,6
BKI,0,0,9,2,11
BKNG,0,1,19,15,35
BKR,0,0,2,4,6
BKU,0,3,0,0,3
BL,0,0,0,1,1
BLDP,0,0,2,4,6
BLDR,0,0,3,1,4
BLDr,0,0,0,1,1
BLFSD,0,1,0,0,1
BLK,0,3,13,10,26
BLKB,0,0,0,1,1
BLL,0,0,8,7,15
BLUE,0,0,4,0,4
BMRN,0,2,3,1,6
BMY,0,1,15,2,18
BNDX,0,0,1,0,1
BNS,0,0,0,1,1
BNTGY,0,0,1,0,1
BOA,0,0,0,1,1
BOH,0,0,1,1,2
BOOM,0,2,0,0,2
BOOT,0,0,2,1,3
BOWX,0,0,0,2,2
BP,0,1,5,5,11
BP PLC,0,0,0,1,1
BPHSPX,0,0,0,1,1
BPMP,0,0,0,7,7
BR,0,0,4,0,4
BRBR,0,1,0,0,1
BREW,0,0,1,0,1
BRHYX,0,0,0,1,1
BRK,0,0,1,0,1
BRK.A,0,2,0,0,2
BRK.B,0,3,39,50,92
BRKB,0,0,0,2,2
BRKR,0,1,1,0,2
BRKS,0,0,2,3,5
BROS,0,0,0,5,5
BRP,0,0,0,3,3
BRX,0,0,0,2,2
BSIIX,0,0,0,1,1
BSIXX,0,0,0,2,2
BSX,0,0,18,19,37
BTC-USD,0,0,0,2,2
BTEC,0,0,0,1,1
BTI,0,2,2,0,4
BTLCY,0,0,1,0,1
BTZ,0,0,1,0,1
BUD,0,0,3,1,4
BUI,0,0,0,2,2
BURBY,0,0,1,0,1
BURL,0,2,2,4,8
BVALX,0,0,1,0,1
BWA,0,0,1,2,3
BWXT,0,0,0,1,1
BX,0,0,19,9,28
BXMDX,0,0,1,0,1
BXMT,0,0,2,2,4
BXP,0,0,4,0,4
BXS,0,9,7,0,16
BXS$A,0,0,6,2,8
BYD,0,0,1,0,1
BYND,0,5,5,0,10
Broadcom Inc.,0,0,0,1,1
C,0,2,18,11,31
CACI,0,0,5,4,9
CAG,0,0,3,0,3
CAH,0,0,1,0,1
CAJ,0,0,2,0,2
CAPL,0,0,2,10,12
CARG,0,0,0,3,3
CARR,0,0,8,7,15
CAT,0,0,5,13,18
CATM,0,0,4,0,4
CATY,0,2,2,0,4
CB,0,3,17,9,29
CBOE,0,0,4,5,9
CBRE,0,0,3,1,4
CBS,0,2,0,0,2
CCC,0,0,2,1,3
CCEP,0,0,4,4,8
CCI,0,0,9,10,19
CCK,0,0,0,2,2
CCL,0,1,7,7,15
CCLAY,0,0,1,0,1
CCMP,0,0,4,0,4
CCOI,0,1,0,0,1
CCS,0,2,0,0,2
CCXI,0,0,0,1,1
CCXX,0,0,2,0,2
CDAY,0,0,4,0,4
CDE,0,1,0,0,1
CDEV,0,1,0,1,2
CDK,0,0,3,1,4
CDNA,0,0,4,5,9
CDNS,0,2,1,10,13
CDW,0,0,2,3,5
CE,0,0,0,1,1
CELC,0,0,2,1,3
CELG,0,1,0,0,1
CELO,0,0,0,1,1
CELO-USD,0,0,0,1,1
CENT,0,2,4,1,7
CENTA,0,2,1,0,3
CEQP,0,0,13,0,13
CERN,0,0,10,4,14
CF,0,2,2,0,4
CFG,0,0,3,1,4
CFJAX,0,0,0,1,1
CFJIX,0,0,0,2,2
CFR,0,0,1,4,5
CG,0,0,2,3,5
CGC,0,0,2,1,3
CGNX,0,1,8,1,10
CHD,0,0,1,5,6
CHDN,0,0,5,4,9
CHE,0,1,1,0,2
CHGCY,0,4,3,1,8
CHGG,0,0,0,2,2
CHH,0,1,0,0,1
CHKP,0,2,4,2,8
CHL,0,3,6,0,9
CHNG,0,0,0,1,1
CHRW,0,0,1,0,1
CHTR,0,0,4,7,11
CHUY,0,1,2,0,3
CHV,0,0,1,0,1
CHWY,0,0,0,17,17
CHX,0,0,0,4,4
CI,0,1,1,5,7
CIBR,0,0,1,1,2
CIEN,0,0,2,0,2
CIG,0,0,0,1,1
CIM,0,0,1,0,1
CINF,0,0,1,0,1
CISIX,0,0,0,1,1
CL,0,7,6,3,16
CLF,0,0,1,3,4
CLGX,0,0,0,1,1
CLNC,0,1,0,0,1
CLNE,0,0,1,8,9
CLX,0,1,4,4,9
CMA,0,0,4,0,4
CMCAS,0,0,0,1,1
CMCSA,0,6,26,9,41
CMD,0,2,3,0,5
CME,0,0,9,8,17
CMG,0,1,3,3,7
CMLFU,0,0,2,3,5
CMLTU,0,0,0,1,1
CMO,0,0,1,0,1
CMP,0,2,2,2,6
CMPR,0,2,0,0,2
CMS,0,0,3,2,5
CMWAY,0,0,2,0,2
CNA,0,0,0,3,3
CNC,0,0,6,4,10
CNF,0,0,0,2,2
CNI,0,2,3,1,6
CNK,0,0,2,0,2
CNP,0,0,4,0,4
CNS,0,1,1,0,2
CO,0,0,0,1,1
CODYY,0,0,1,0,1
COF,0,1,4,3,8
COHR,0,0,0,1,1
COIN,0,0,0,20,20
COLD,0,1,4,6,11
COMM,0,0,2,3,5
CONE,0,0,2,1,3
COO,0,0,1,0,1
COP,0,3,6,2,11
COR,0,1,0,0,1
COST,0,2,30,15,47
COTY,0,1,1,0,2
COUP,0,1,0,0,1
COVTY,0,0,1,0,1
CPRI,0,0,1,0,1
CR,0,0,1,1,2
CRARY,0,0,1,0,1
CREE,0,1,0,3,4
CRL,0,1,0,1,2
CRM,0,0,21,13,34
CRNC,0,0,4,0,4
CRON,0,0,1,1,2
CRRFY,0,0,1,0,1
CRSP,0,0,0,2,2
CRUS,0,2,0,0,2
CRWD,0,0,4,14,18
CRY,0,0,8,0,8
CRZBY,0,0,2,0,2
CS,0,0,1,1,2
CSCCX,0,0,0,1,1
CSCO,0,4,12,11,27
CSGP,0,0,11,2,13
CSIQ,0,0,1,0,1
CSL,0,0,3,3,6
CSLT,0,4,3,0,7
CSPCY,0,0,0,4,4
CSQ,0,0,1,0,1
CSTL,0,0,2,0,2
CSX,0,0,2,2,4
CTAS,0,0,1,5,6
CTB,0,1,0,0,1
CTBI,0,0,1,0,1
CTL,0,0,4,0,4
CTLT,0,0,15,1,16
CTRCF,0,0,2,0,2
CTRM,0,0,0,1,1
CTSH,0,0,5,7,12
CTVA,0,1,1,2,4
CTXS,0,1,4,1,6
CUK,0,0,1,0,1
CVET,0,3,7,2,12
CVGW,0,1,0,0,1
CVI,0,0,5,0,5
CVLT,0,1,0,0,1
CVNA,0,0,5,1,6
CVS,0,2,11,15,28
CVX,0,2,27,16,45
CW,0,0,9,0,9
CWB,0,3,1,0,4
CWEN,0,2,0,0,2
CWEN.A,0,1,5,2,8
CWGIX,0,0,0,1,1
CWH,0,0,0,1,1
CWK,0,0,0,4,4
CXP,0,2,0,0,2
CXW,0,0,2,0,2
CYRX,0,1,11,1,13
CZR,0,0,0,3,3
D,0,0,14,16,30
DAIUF,0,1,9,3,13
DAL,0,0,8,0,8
DANOY,0,0,1,1,2
DASH,0,0,1,6,7
DASTY,0,5,5,4,14
DAVA,0,0,6,4,10
DAWC,0,0,0,1,1
DB,0,0,1,0,1
DBD,0,2,0,0,2
DBSDY,0,2,2,3,7
DBX,0,0,1,0,1
DCI,0,0,3,1,4
DCMYY,0,0,1,0,1
DCP,0,0,8,0,8
DD,0,8,10,9,27
DDD,0,0,0,1,1
DE,0,0,4,23,27
DEACU,0,0,18,0,18
DECK,0,4,0,6,10
DELL,0,0,3,3,6
DENN,0,0,1,0,1
DEO,0,2,11,2,15
DESY,0,0,0,1,1
DFREX,0,0,1,0,1
DFS,0,0,4,4,8
DG,0,0,11,9,20
DGRO,0,0,7,3,10
DGX,0,0,5,1,6
DHR,0,2,8,5,15
DIA,0,1,19,0,20
DIAL,0,0,0,4,4
DIN,0,3,2,0,5
DIS,0,3,35,26,64
DISCA,0,1,3,2,6
DISCK,0,0,1,0,1
DIV,0,0,1,0,1
DKNG,0,0,21,6,27
DLAKY,0,0,1,0,1
DLB,0,1,0,0,1
DLR,0,2,6,4,12
DLTR,0,0,15,1,16
DMRC,0,1,0,0,1
DMTK,0,0,0,1,1
DNB,0,0,3,0,3
DNKEY,0,0,1,0,1
DNKN,0,0,2,0,2
DNNGY,0,0,1,0,1
DNOW,0,1,0,0,1
DNTUY,0,5,4,0,9
DNZOY,0,0,1,0,1
DOCU,0,0,1,4,5
DODWX,0,0,0,1,1
DOGE-USD,0,0,0,4,4
DOMO,0,5,0,1,6
DOOR,0,1,0,0,1
DORM,0,1,3,0,4
DOV,0,0,5,4,9
DOW,0,7,3,1,11
DOX,0,0,3,0,3
DPSGY,0,0,2,0,2
DPZ,0,0,3,3,6
DRE,0,0,3,3,6
DRI,0,0,4,1,5
DRQ,0,2,2,0,4
DSDVY,0,0,1,0,1
DSGX,0,0,2,0,2
DSU,0,0,1,0,1
DTCWY,0,0,1,0,1
DTE,0,0,3,1,4
DTEGY,0,0,1,0,1
DTM,0,0,0,1,1
DUK,0,1,9,6,16
DUKH,0,0,0,1,1
DUSA,0,0,1,0,1
DVN,0,0,0,8,8
DWAC,0,0,0,1,1
DWAHY,0,0,1,0,1
DWDP,0,2,0,0,2
DXC,0,1,6,3,10
DXCM,0,0,6,2,8
E,0,0,1,0,1
EA,0,0,1,5,6
EBAY,0,0,2,1,3
EBJ,0,0,1,0,1
EBS,0,0,7,4,11
EBSB,0,1,4,0,5
ECL,0,0,25,7,32
ECOL,0,1,1,0,2
ED,0,0,5,0,5
EDIT,0,3,5,2,10
EDU,0,0,3,0,3
EEFT,0,2,0,0,2
EFG,0,0,2,0,2
EFV,0,0,1,0,1
EFX,0,0,3,2,5
EGBN,0,1,0,0,1
EGHT,0,2,0,0,2
EGP,0,1,0,0,1
EHC,0,0,2,1,3
EHSTX,0,0,0,1,1
EIX,0,0,1,0,1
EJPRY,0,0,1,0,1
EL,0,1,23,11,35
ELAN,0,0,7,2,9
ELUXY,0,0,1,0,1
EMKR,0,0,0,3,3
EMN,0,0,2,1,3
EMR,0,0,10,7,17
EMXC,0,0,0,2,2
ENB,0,2,0,2,4
ENBL,0,0,18,14,32
ENGGY,0,0,1,0,1
ENGIY,0,0,2,0,2
ENLAY,0,0,1,0,1
ENLC,0,0,11,22,33
ENPH,0,0,1,2,3
ENR,0,0,3,0,3
ENS,0,0,1,0,1
ENTG,0,0,9,0,9
ENV,0,0,3,0,3
EOG,0,0,3,1,4
EOS-USD,0,0,0,1,1
EPAM,0,0,3,2,5
EPAY,0,0,1,0,1
EPD,0,0,6,14,20
EPOKY,0,3,2,0,5
EPR,0,0,1,0,1
EQIX,0,0,3,5,8
EQNR,0,0,1,1,2
EQUIX,0,0,0,1,1
ERH,0,1,0,0,1
ERIC,0,0,4,1,5
ERJ,0,0,0,2,2
ES,0,0,2,2,4
ESGC,0,0,0,2,2
ESGD,0,0,0,1,1
ESGR,0,3,0,0,3
ESGU,0,0,1,1,2
ESI,0,0,10,1,11
ESNT,0,2,0,0,2
ESS,0,0,1,0,1
ESTC,0,0,0,3,3
ET,0,0,22,22,44
ETC-USD,0,0,0,2,2
ETFC,0,0,1,0,1
ETH-USD,0,0,0,2,2
ETN,0,2,7,12,21
ETP,0,0,1,0,1
ETR,0,0,2,1,3
ETSY,0,0,0,3,3
ETV,0,0,0,1,1
ETWO.W,0,0,0,1,1
EVBG,0,0,2,1,3
EVGB,0,0,0,1,1
EVH,0,0,1,0,1
EVOP,0,2,0,0,2
EVV,0,0,1,0,1
EVVTY,0,0,2,0,2
EW,0,0,3,6,9
EWBC,0,0,0,1,1
EWU,0,0,0,1,1
EXAS,0,3,10,5,18
EXC,0,1,2,0,3
EXEL,0,4,0,0,4
EXLS,0,0,3,0,3
EXPD,0,1,5,1,7
EXPE,0,1,0,3,4
F,0,1,17,8,26
FAF,0,2,0,0,2
FAFTX,0,0,0,1,1
FANG,0,0,2,1,3
FANUF,0,1,9,2,12
FANUY,0,3,2,1,6
FAS,0,0,8,0,8
FAST,0,0,5,0,5
FB,0,2,46,45,93
FBALX,0,0,0,1,1
FBC,0,2,0,0,2
FBGRX,0,0,1,0,1
FBMPX,0,0,1,0,1
FBND,0,0,0,1,1
FBSI,0,2,0,0,2
FCEL,0,0,7,5,12
FCFS,0,0,2,2,4
FCGAX,0,0,1,0,1
FCN,0,0,0,2,2
FCNTX,0,0,1,0,1
FCX,0,2,2,7,11
FCYIX,0,0,1,0,1
FDIS,0,0,0,1,1
FDL,0,0,6,0,6
FDN,0,0,5,1,6
FDRR,0,0,2,1,3
FDRXX,0,0,0,2,2
FDS,0,0,1,0,1
FDX,0,1,4,30,35
FE,0,0,4,0,4
FEDX,0,0,0,1,1
FEI,0,0,1,0,1
FEPAX,0,0,0,1,1
FEYE,0,0,2,1,3
FFG,0,0,0,1,1
FFHRX,0,1,0,0,1
FFIN,0,1,0,0,1
FFRHX,0,1,0,0,1
FHB,0,0,2,0,2
FHLC,0,0,0,1,1
FHN,0,0,5,1,6
FIBK,0,1,0,0,1
FIDSX,0,0,2,0,2
FII,0,4,0,0,4
FIKMX,0,3,1,0,4
FINMY,0,0,1,0,1
FINX,0,0,0,1,1
FIS,0,0,19,10,29
FISI,0,0,1,0,1
FISV,0,0,5,9,14
FITB,0,0,2,4,6
FIVE,0,2,5,1,8
FIVN,0,0,1,1,2
FLCB,0,0,1,0,1
FLCO,0,0,1,0,1
FLEX,0,1,2,2,5
FLIR,0,1,11,1,13
FLQL,0,0,1,0,1
FLR,0,2,2,1,5
FLS,0,0,2,0,2
FLT,0,0,7,1,8
FLVEX,0,0,1,0,1
FLXN,0,1,1,0,2
FMAO,0,0,1,0,1
FMAT,0,0,0,1,1
FMC,0,0,2,0,2
FMCMF,0,0,1,0,1
FMS,0,0,0,8,8
FMX,0,2,2,3,7
FNB,0,2,0,0,2
FND,0,0,1,0,1
FNF,0,1,3,4,8
FNGZX,0,0,1,0,1
FNRVGX,0,0,0,1,1
FNV,0,0,1,3,4
FORD,0,0,0,1,1
FOUR,0,0,1,2,3
FOXA,0,1,1,0,2
FOXF,0,1,0,0,1
FPEI,0,0,0,1,1
FQAL,0,0,0,1,1
FRC,0,0,3,3,6
FRFHF,0,0,2,0,2
FSCPX,0,0,1,0,1
FSD,0,0,2,0,2
FSEN,0,0,0,1,1
FSK,0,1,0,2,3
FSKAX,0,0,0,2,2
FSKR,0,0,0,2,2
FSLR,0,0,3,5,8
FSPHX,0,0,2,0,2
FSPTX,0,0,1,0,1
FSSAX,0,0,1,0,1
FSTFX,0,1,0,0,1
FTA,0,0,1,0,1
FTDR,0,0,3,0,3
FTEC,0,0,0,1,1
FTNT,0,1,9,1,11
FTQGX,0,0,1,0,1
FTSM,0,0,1,0,1
FTTGLX,0,0,0,1,1
FTV,0,1,3,1,5
FUJHY,0,0,1,0,1
FUND,0,0,0,2,2
FUPBY,0,1,3,1,5
FVADX,0,0,1,0,1
FVD,0,0,1,0,1
FVRR,0,0,1,3,4
FWONK,0,0,1,0,1
FXM,0,0,1,0,1
G,0,3,0,0,3
GBCI,0,0,1,0,1
GBDC,0,1,1,0,2
GBOOY,0,3,0,0,3
GBT,0,2,0,0,2
GBTC,0,0,0,2,2
GBX,0,1,0,0,1
GCGMF,0,0,0,1,1
GCI,0,1,0,0,1
GCIIX,0,0,1,0,1
GCO,0,1,0,0,1
GCP,0,0,1,0,1
GD,0,1,7,0,8
GDDY,0,2,4,11,17
GDRX,0,0,0,1,1
GE,0,2,18,10,30
GEAGY,0,0,1,0,1
GEL,0,0,19,2,21
GFL,0,0,3,0,3
GFN,0,0,3,2,5
GGT,0,0,1,0,1
GH,0,0,7,1,8
GHC,0,0,0,2,2
GILD,0,1,14,5,20
GIS,0,0,5,4,9
GISYX,0,0,1,0,1
GLD,0,0,5,4,9
GLIBA,0,0,2,0,2
GLOB,0,0,2,0,2
GLOP,0,0,15,0,15
GLP,0,0,8,8,16
GLPEY,0,0,1,0,1
GLPI,0,0,0,1,1
GLW,0,0,3,0,3
GM,0,0,5,12,17
GME,0,0,0,1,1
GMED,0,0,4,0,4
GMLP,0,0,14,0,14
GNRC,0,0,1,31,32
GO,0,0,3,1,4
GOLD,0,0,2,2,4
GOOC.VI,0,0,0,1,1
GOOG,0,4,24,20,48
GOOGL,0,1,24,18,43
GOOS,0,1,4,0,5
GOVT,0,0,1,0,1
GPC,0,1,4,2,7
GPK,0,0,5,1,6
GPN,0,0,9,7,16
GPRO,0,0,0,2,2
GPS,0,0,0,1,1
GRA,0,0,1,0,1
GRFS,0,1,0,0,1
GRNC,0,0,0,1,1
GRUB,0,0,1,1,2
GS,0,1,12,9,22
GSAH,0,0,3,0,3
GSK,0,0,11,6,17
GSLC,0,3,10,0,13
GSMTX,0,0,1,0,1
GSOSX,0,0,0,1,1
GSS,0,0,0,1,1
GT,0,1,0,2,3
GTN,0,0,0,1,1
GWPH,0,0,1,0,1
GWRE,0,0,1,0,1
GWW,0,0,1,0,1
GXO,0,0,0,2,2
H,0,3,0,1,4
HACK,0,1,0,0,1
HAE,0,0,7,3,10
HAL,0,0,1,0,1
HALO,0,0,2,1,3
HAS,0,0,2,0,2
HASI,0,0,5,0,5
HAYN,0,0,2,0,2
HBAN,0,0,3,0,3
HBI,0,0,0,3,3
HCA,0,0,4,6,10
HCN,0,0,1,0,1
HCSG,0,1,1,0,2
HD,0,3,29,27,59
HDB,0,1,2,1,4
HDELY,0,0,1,0,1
HDS,0,0,7,0,7
HE,0,3,0,0,3
HEI,0,0,0,1,1
HELE,0,0,5,0,5
HEP,0,0,1,0,1
HES,0,0,0,2,2
HFC,0,1,0,0,1
HGIIX,0,0,1,0,1
HHC,0,0,5,5,10
HIG,0,0,4,3,7
HII,0,0,1,0,1
HIPO,0,0,0,1,1
HIW,0,3,0,0,3
HL,0,2,0,0,2
HLDCY,0,0,1,0,1
HLIO,0,0,2,1,3
HLPPY,0,0,1,0,1
HLT,0,0,3,4,7
HLUYY,0,0,1,0,1
HMC,0,0,1,0,1
HMN,0,0,9,0,9
HNDL,0,0,0,3,3
HNNMY,0,0,1,0,1
HNST,0,0,0,1,1
HOFV,0,0,0,1,1
HOG,0,0,2,0,2
HOLX,0,0,5,2,7
HON,0,1,15,17,33
HOn,0,0,0,1,1
HP,0,1,0,2,3
HPE,0,0,1,0,1
HPP,0,0,1,1,2
HPQ,0,3,3,0,6
HQY,0,0,6,5,11
HR,0,1,0,0,1
HRB,0,0,4,0,4
HRC,0,2,2,1,5
HRI,0,0,3,0,3
HRL,0,1,2,1,4
HRTX,0,0,0,1,1
HS,0,0,0,2,2
HSBC,0,1,7,1,9
HSHCY,0,0,0,2,2
HSIC,0,0,1,3,4
HSNGY,0,0,1,0,1
HST,0,0,4,2,6
HTA,0,0,1,0,1
HTHIY,0,0,1,0,1
HTLD,0,0,1,1,2
HTZ,0,0,1,0,1
HUBS,0,0,9,1,10
HUM,0,0,4,6,10
HUN,0,0,0,2,2
HUYA,0,4,11,0,15
HVRRY,0,0,1,0,1
HWM,0,0,1,0,1
HXGBY,0,0,1,0,1
HXL,0,0,7,2,9
HYDB,0,0,0,1,1
HZD,0,0,1,0,1
HZN,0,0,1,0,1
IAC,0,0,1,0,1
IART,0,1,5,0,6
IAT,0,0,1,0,1
IAU,0,0,6,4,10
IBDO,0,0,0,1,1
IBDP,0,0,0,1,1
IBDRY,0,0,1,0,1
IBKR,0,0,1,0,1
IBM,0,1,13,16,30
IBN,0,1,3,1,5
IBTB,0,0,0,1,1
IBTD,0,0,0,2,2
IBTG,0,0,0,1,1
IBTH,0,0,0,1,1
IBTI,0,0,0,1,1
IBTJ,0,0,0,1,1
ICE,0,1,11,6,18
ICFI,0,0,2,0,2
ICL,0,0,1,0,1
ICLR,0,0,1,2,3
ICSH,0,0,0,1,1
ICUI,0,0,6,0,6
IDA,0,0,1,0,1
IDV,0,0,1,0,1
IDXX,0,0,4,0,4
IDXXX,0,0,0,1,1
IEF,0,0,1,0,1
IEFA,0,1,2,0,3
IEMG,0,0,1,2,3
IFF,0,0,3,3,6
IFNNY,0,2,7,6,15
IGLB,0,0,0,2,2
IGV,0,0,1,0,1
IHG,0,0,1,0,1
IHI,0,0,1,0,1
IJH,0,2,0,0,2
IJR,0,2,1,0,3
ILMN,0,2,9,8,19
ILPT,0,0,0,4,4
IMBBY,0,0,3,0,3
INCY,0,0,2,0,2
INFO,0,0,4,16,20
INFR,0,0,1,0,1
ING,0,0,2,0,2
INMD,0,0,2,0,2
INO,0,0,1,0,1
INRE,0,0,0,1,1
INST,0,0,1,0,1
INTC,0,0,21,9,30
INTL,0,0,0,1,1
INTU,0,3,8,8,19
INVH,0,0,4,0,4
IONS,0,2,0,0,2
IP,0,0,2,2,4
IPG,0,0,2,1,3
IPWR,0,0,1,0,1
IPXHY,0,0,1,0,1
IQV,0,1,7,7,15
IR,0,0,10,1,11
IRM,0,2,6,5,13
IRTC,0,1,0,0,1
IS,0,0,0,1,1
ISD,0,0,1,0,1
ISNPY,0,0,1,0,1
ISRG,0,1,9,5,15
ISUZY,0,0,1,0,1
IT,0,0,8,1,9
ITCI,0,0,0,1,1
ITOT,0,0,1,0,1
ITUB,0,3,4,3,10
ITW,0,0,6,2,8
IVE,0,1,0,0,1
IVV,0,2,2,0,4
IVW,0,0,1,1,2
IVZ,0,2,3,0,5
IWF,0,0,0,1,1
IWM,0,0,4,0,4
IWN,0,1,10,3,14
IWR,0,0,0,1,1
IWV,0,0,1,0,1
IX,0,0,1,0,1
IXJ,0,0,0,1,1
IYZ,0,0,0,1,1
J,0,0,4,3,7
JAPAY,0,0,2,0,2
JAPSY,0,0,2,0,2
JAZZ,0,0,0,1,1
JBAXY,0,0,1,0,1
JBI,0,0,0,1,1
JBL,0,0,0,1,1
JBT,0,0,2,0,2
JCI,0,2,2,0,4
JEF,0,1,1,1,3
JEMWX,0,0,1,0,1
JEPI,0,0,0,1,1
JETS,0,0,1,0,1
JFAMX,0,0,1,0,1
JGCCF,0,0,0,1,1
JGCCY,0,2,0,0,2
JHX,0,0,1,0,1
JIH,0,0,0,13,13
JKHY,0,0,4,0,4
JLL,0,0,0,1,1
JNJ,0,9,25,23,57
JNK,0,0,0,1,1
JOE,0,0,0,1,1
JPM,0,9,26,27,62
JPM$G,0,0,2,0,2
JQC,0,0,0,1,1
JSAIY,0,0,1,0,1
JSOAX,0,0,0,1,1
JWN,0,1,1,0,2
K,0,4,1,0,5
KAI,0,0,0,3,3
KBE,0,0,1,0,1
KDP,0,1,2,0,3
KEY,0,0,6,0,6
KEYS,0,0,2,1,3
KGFHY,0,0,1,0,1
KHC,0,4,5,4,13
KIDS,0,0,2,0,2
KIM,0,0,1,0,1
KKPNY,0,0,1,0,1
KKR,0,0,1,8,9
KLAC,0,0,1,1,2
KMB,0,0,7,5,12
KMI,0,1,4,4,9
KMPR,0,0,4,0,4
KMT,0,2,0,0,2
KMTUY,0,2,4,1,7
KMX,0,0,12,2,14
KNRRY,0,0,1,0,1
KO,0,4,12,18,34
KPELY,0,0,1,0,1
KPLT,0,0,1,4,5
KPLTW,0,0,0,6,6
KR,0,0,11,11,22
KRE,0,0,0,6,6
KRNT,0,0,1,0,1
KSS,0,1,2,0,3
KTB,0,0,2,0,2
KTOS,0,0,15,12,27
KUBTY,0,4,1,2,7
KYOCF,0,0,0,1,1
L,0,0,7,0,7
LAD,0,0,3,1,4
LAM,0,0,1,0,1
LAMR,0,0,1,0,1
LANC,0,1,0,0,1
LAND,0,0,2,0,2
LARCX,0,0,0,1,1
LAUR,0,2,0,0,2
LB,0,1,2,1,4
LBDAV,0,0,1,0,1
LBRDA,0,0,3,6,9
LBRDK,0,1,0,2,3
LCGFX,0,0,0,2,2
LCID,0,0,0,1,1
LCRX,0,0,0,3,3
LDNXF,0,0,6,1,7
LDOS,0,0,4,6,10
LEA,0,0,0,3,3
LEE,0,0,2,2,4
LEG,0,0,0,1,1
LEN,0,0,4,0,4
LEN.B,0,0,2,0,2
LESL,0,0,0,4,4
LEVI,0,0,2,0,2
LGI,0,0,0,2,2
LGND,0,0,4,0,4
LH,0,0,4,0,4
LHCG,0,0,7,3,10
LHX,0,1,9,4,14
LII,0,0,1,0,1
LIN,0,1,6,9,16
LINK-USD,0,0,0,2,2
LITE,0,0,3,1,4
LKQ,0,0,4,1,5
LL,0,0,0,1,1
LLL,0,1,0,0,1
LLY,0,0,7,3,10
LMND,0,0,0,7,7
LMT,0,4,4,16,24
LNC,0,0,2,0,2
LNSTY,0,0,1,0,1
LNT,0,0,7,1,8
LOGI,0,0,1,0,1
LOPE,0,0,1,1,2
LOW,0,2,8,8,18
LPLA,0,0,2,3,5
LPRO,0,0,0,1,1
LPT,0,0,1,0,1
LQD,0,0,0,1,1
LRCX,0,0,3,6,9
LRLCY,0,1,1,2,4
LRNZ,0,0,0,2,2
LSFYX,0,0,1,0,1
LSXMK,0,1,2,1,4
LTD,0,0,0,3,3
LTHM,0,0,1,0,1
LUKOY,0,4,4,2,10
LULU,0,0,2,6,8
LUMN,0,0,3,3,6
LUV,0,0,24,10,34
LVMHF,0,0,4,1,5
LVMUY,0,3,3,0,6
LVS,0,0,7,1,8
LW,0,1,4,5,10
LYB,0,0,3,1,4
LYFT,0,0,4,0,4
LYG,0,0,3,0,3
LYV,0,1,1,5,7
LZ,0,0,0,3,3
LZAGY,0,1,1,3,5
M,0,1,3,0,4
MA,0,1,23,16,40
MAA,0,0,2,0,2
MAC,0,1,1,0,2
MADCX,0,0,1,0,1
MAIN,0,0,0,1,1
MALRX,0,0,1,0,1
MANH,0,1,0,0,1
MANLX,0,0,1,0,1
MAR,0,0,5,3,8
MARA,0,0,1,0,1
MAS,0,0,5,1,6
MASI,0,0,0,2,2
MAT,0,0,3,1,4
MAYHX,0,0,1,0,1
MBB,0,0,0,2,2
MC,0,1,0,0,1
MCD,0,3,10,7,20
MCHP,0,1,2,1,4
MCK,0,0,2,3,5
MCO,0,0,1,3,4
MCRN,0,0,3,0,3
MCS,0,0,0,1,1
MD,0,1,0,0,1
MDB,0,0,0,3,3
MDIBY,0,0,2,0,2
MDLZ,0,1,5,3,9
MDNDF,0,0,0,1,1
MDT,0,1,11,11,23
MDY,0,1,0,1,2
MDYG,0,0,1,4,5
MDYV,0,0,1,3,4
MED,0,2,0,0,2
MEDP,0,0,4,1,5
MELI,0,0,3,5,8
MEOH,0,0,1,0,1
MET,0,0,3,16,19
MFC,0,0,1,0,1
MFG,0,0,2,0,2
MFGP,0,0,2,0,2
MFYV,0,0,0,1,1
MGA,0,0,1,0,1
MGM,0,0,2,1,3
MGPI,0,1,0,0,1
MGY,0,0,0,2,2
MHK,0,0,1,0,1
MINI,0,1,0,0,1
MITEY,0,0,1,0,1
MITK,0,0,0,1,1
MITSY,0,0,1,0,1
MJDLF,0,0,0,1,1
MJNA,0,0,0,1,1
MKC,0,0,1,1,2
MKL,0,5,0,8,13
MKTX,0,0,2,5,7
MLCO,0,0,1,0,1
MLYNF,0,0,0,1,1
MMC,0,0,7,4,11
MMLP,0,0,7,0,7
MMM,0,3,9,0,12
MMP,0,0,5,38,43
MNP,0,0,1,0,1
MNST,0,0,3,0,3
MNTA,0,0,1,0,1
MO,0,0,12,10,22
MONOY,0,3,0,0,3
MORN,0,0,1,0,1
MOS,0,1,6,1,8
MPC,0,0,5,0,5
MPLN,0,0,1,0,1
MPLX,0,0,12,8,20
MPWR,0,1,0,0,1
MRCK,0,0,1,0,1
MRIN,0,0,0,1,1
MRK,0,0,14,18,32
MRNA,0,0,1,10,11
MRVL,0,0,0,3,3
MRWSY,0,0,2,0,2
MS,0,0,4,23,27
MSB,0,0,0,1,1
MSBHY,0,0,2,0,2
MSCI,0,2,12,4,18
MSFT,0,6,125,85,216
MSI,0,0,3,2,5
MSM,0,0,1,0,1
MSTR,0,1,0,0,1
MTB,0,1,4,1,6
MTBC,0,0,0,4,4
MTCH,0,0,3,16,19
MTD,0,1,0,0,1
MTDR,0,1,1,1,3
MTH,0,2,0,0,2
MTN,0,0,1,0,1
MTSC,0,0,3,0,3
MTSI,0,1,2,0,3
MTX,0,0,3,1,4
MU,0,0,8,2,10
MUB,0,0,0,1,1
MUFG,0,0,1,0,1
MUR,0,0,4,2,6
MYE,0,0,1,0,1
MYL,0,1,0,0,1
MZDAY,0,0,1,0,1
MZOR,1,0,0,0,1
NABZY,0,0,1,0,1
NATI,0,1,1,0,2
NBIX,0,0,2,2,4
NBL,0,0,2,0,2
NBLX,0,0,13,0,13
NCLH,0,0,2,1,3
NCLTY,0,0,2,2,4
NCMGF,0,0,0,1,1
NDAQ,0,1,5,5,11
NEE,0,4,24,16,44
NEM,0,0,6,2,8
NEO,0,0,1,2,3
NEOG,0,1,1,0,2
NEWFX,0,0,0,1,1
NFFFX,0,0,0,1,1
NFG,0,0,12,10,22
NFLX,0,0,9,31,40
NGG,0,0,5,0,5
NGL,0,0,24,13,37
NGLS,0,0,1,0,1
NHI,0,0,1,6,7
NI,0,0,3,1,4
NICE,0,0,3,0,3
NINOY,0,0,2,0,2
NIO,0,0,2,1,3
NKE,0,1,13,6,20
NLG,0,0,0,1,1
NLOK,0,0,4,1,5
NLSN,0,1,0,0,1
NLY,0,0,1,0,1
NMIH,0,0,2,0,2
NNGRY,0,0,1,0,1
NNN,0,0,1,1,2
NOC,0,0,3,7,10
NOK,0,0,1,0,1
NOV,0,2,0,0,2
NOW,0,0,9,2,11
NPSNY,0,2,0,0,2
NRDBY,0,0,1,0,1
NRG,0,0,0,2,2
NS,0,0,0,11,11
NSANY,0,0,1,0,1
NSC,0,0,1,4,5
NSIT,0,0,0,2,2
NSP,0,2,2,1,5
NSRGY,0,6,19,9,34
NTAP,0,0,34,77,111
NTDOY,0,0,3,2,5
NTLA,0,0,4,4,8
NTNX,0,1,0,0,1
NTOIY,0,0,2,0,2
NTR,0,0,1,0,1
NTRS,0,0,7,0,7
NTTYY,0,0,1,0,1
NTXFY,0,0,1,0,1
NUAN,0,1,1,0,2
NUE,0,1,3,1,5
NUGL,0,0,0,1,1
NULC,0,0,0,2,2
NULG,0,0,1,1,2
NULV,0,0,0,1,1
NVCR,0,2,0,1,3
NVDA,0,1,23,47,71
NVEE,0,0,6,1,7
NVIGF,0,0,1,0,1
NVLIX,0,0,0,1,1
NVO,0,0,3,1,4
NVR,0,0,0,4,4
NVS,0,1,14,2,17
NVT,0,0,2,2,4
NVVE,0,0,1,7,8
NVZMY,0,1,3,1,5
NWE,0,0,1,0,1
NWG,0,0,1,0,1
NWL,0,0,4,1,5
NWN,0,0,5,4,9
NWS,0,0,2,0,2
NWSA,0,0,2,0,2
NXPI,0,0,4,4,8
NXST,0,0,4,0,4
NYT,0,0,0,2,2
O,0,0,4,4,8
OAKGX,0,0,0,1,1
OCFC,0,0,2,1,3
ODFL,0,0,0,1,1
OGFGF,0,0,0,1,1
OGN,0,0,0,2,2
OHI,0,0,2,0,2
OIH,0,0,1,0,1
OKE,0,0,13,5,18
OKTA,0,0,0,1,1
OLED,0,0,12,0,12
OLLI,0,0,5,4,9
OLP,0,0,8,4,12
OMBIX,0,0,1,0,1
OMC,0,1,3,0,4
OMCL,0,0,0,1,1
OMF,0,0,0,1,1
OMVKY,0,0,1,0,1
ON,0,0,2,2,4
ONTO,0,0,1,0,1
ORA,0,0,0,1,1
ORAN,0,0,3,2,5
ORCC,0,0,0,4,4
ORCL,0,0,9,5,14
ORLT,0,0,1,0,1
ORLY,0,0,5,7,12
ORMP,0,0,0,2,2
OSUR,0,0,1,1,2
OSW,0,0,6,2,8
OTIS,0,0,9,1,10
OWCIX,0,0,1,0,1
OWLSX,0,0,3,3,6
OWMBX,0,0,0,1,1
OWSMX,0,0,2,1,3
OWSOX,0,0,2,0,2
OXM,0,2,0,0,2
OXY,0,3,2,0,5
PAA,0,0,0,13,13
PACW,0,1,0,0,1
PAG,0,0,0,2,2
PAGS,0,0,0,3,3
PAHC,0,0,0,2,2
PAIDX,0,0,0,2,2
PANDY,0,0,2,0,2
PANW,0,0,2,0,2
PARMX,0,0,0,1,1
PASO,0,0,8,0,8
PATK,0,2,1,0,3
PAVE,0,0,2,0,2
PAYC,0,0,2,2,4
PAYX,0,0,4,0,4
PB,0,1,0,0,1
PBA,0,0,0,2,2
PBCT,0,4,2,0,6
PBF,0,0,3,1,4
PBFX,0,0,15,15,30
PBYI,0,2,0,0,2
PCAR,0,0,3,3,6
PCH,0,3,0,0,3
PCPL,0,0,1,0,1
PCPL.U,0,0,0,1,1
PCRFY,0,0,1,0,1
PCRX,0,0,0,2,2
PCTY,0,0,6,1,7
PDBC,0,0,0,1,1
PDCE,0,3,0,0,3
PDM,0,2,0,0,2
PDS,0,0,0,1,1
PDX,0,0,0,1,1
PDYPY,0,0,1,0,1
PEAK,0,0,4,0,4
PEB,0,2,3,0,5
PEG,0,0,2,0,2
PEGA,0,0,1,0,1
PEGI,0,1,0,0,1
PEJ,0,0,0,1,1
PENN,0,0,1,3,4
PEP,0,2,20,12,34
PFE,0,4,18,14,36
PFG,0,0,2,0,2
PFGC,0,0,4,1,5
PFPT,0,0,1,1,2
PG,0,1,14,18,33
PGNY,0,0,4,0,4
PGR,0,2,11,14,27
PGRE,0,3,0,0,3
PGX,0,0,0,1,1
PH,0,0,3,6,9
PHG,0,0,9,1,10
PHM,0,3,4,1,8
PHR,0,0,7,1,8
PHX,0,0,0,1,1
PI,0,0,2,1,3
PII,0,0,3,1,4
PIMIX,0,0,2,1,3
PINS,0,0,2,3,5
PK,0,0,2,0,2
PKCOY,0,2,0,0,2
PKG,0,0,0,2,2
PKI,0,1,1,0,2
PLCE,0,2,0,0,2
PLD,0,1,4,3,8
PLNT,0,5,7,2,14
PLT,0,0,0,1,1
PLTR,0,0,0,1,1
PLUG,0,0,2,8,10
PLXS,0,0,2,4,6
PLYA,0,0,3,0,3
PM,0,1,15,6,22
PMUPX,0,0,1,0,1
PNC,0,0,10,3,13
PNGAY,0,3,2,4,9
PNR,0,2,0,0,2
PNW,0,3,0,0,3
POAHY,0,0,1,0,1
PODD,0,0,0,1,1
POL,0,1,2,0,3
PONPX,0,0,0,1,1
POOL,0,0,0,2,2
POR,0,0,6,0,6
POST,0,3,3,0,6
POWI,0,1,2,0,3
PPBI,0,1,6,0,7
PPG,0,1,11,6,18
PPL,0,0,7,4,11
PPRUY,0,0,1,0,1
PRA,0,2,1,0,3
PRAA,0,0,2,0,2
PRAH,0,0,5,0,5
PRGO,0,0,1,0,1
PRGS,0,2,0,3,5
PRGTX,0,0,0,1,1
PRIM,0,1,3,0,4
PRLB,0,0,1,0,1
PROF,0,0,2,0,2
PROSY,0,0,1,0,1
PRSP,0,0,2,0,2
PRU,0,1,8,1,10
PRWCX,0,0,1,0,1
PS,0,2,6,0,8
PSA,0,0,2,3,5
PSB,0,1,0,0,1
PSMMY,0,0,1,0,1
PSNL,0,0,3,0,3
PSO,0,0,1,0,1
PSQ,0,0,12,0,12
PSTH,0,0,1,0,1
PSX,0,1,7,1,9
PSXP,0,0,0,4,4
PTC,0,0,0,2,2
PTEN,0,1,0,0,1
PTON,0,0,0,14,14
PUBGY,0,0,1,0,1
PUK,0,0,1,0,1
PUMP,0,2,0,0,2
PUTW,0,0,1,0,1
PVH,0,0,1,0,1
PWR,0,0,3,2,5
PXD,0,0,3,6,9
PYCR,0,0,0,2,2
PYPL,0,0,16,33,49
QCHR,0,0,0,1,1
QCOM,0,4,8,10,22
QDEL,0,0,8,5,13
QGEN,0,2,2,0,4
QMCO,0,0,0,3,3
QQQ,0,2,3,2,7
QRTEA,0,1,0,0,1
QS,0,0,0,3,3
QSR,0,0,3,0,3
QSY,0,0,1,0,1
QTS,0,3,1,1,5
QYLD,0,0,1,0,1
R,0,0,0,7,7
RAD,0,0,1,0,1
RAND,0,0,6,0,6
RARE,0,0,0,1,1
RBA,0,0,7,0,7
RBCAA,0,0,2,0,2
RBLX,0,0,0,16,16
RBS,0,0,1,0,1
RCI,0,0,1,0,1
RCII,0,2,0,0,2
RCKY,0,2,0,0,2
RCL,0,0,3,0,3
RDEIY,0,0,1,0,1
RDFN,0,1,0,0,1
RDS.A,0,0,3,2,5
RDS.B,0,3,6,1,10
RDUS,0,3,0,0,3
REG,0,1,0,0,1
REGL,0,0,1,1,2
REGN,0,1,10,5,16
REPYY,0,0,2,0,2
RETA,0,0,1,1,2
REXR,0,2,0,0,2
REYN,0,0,7,0,7
REZI,0,0,0,3,3
RF,0,0,3,0,3
RF$A,0,0,1,0,1
RGA,0,1,0,1,2
RGLD,0,2,1,4,7
RHHBF,0,0,2,1,3
RHHBY,0,4,10,5,19
RHI,0,0,2,2,4
RHP,0,2,1,0,3
RIO,0,3,4,2,9
RIVN,0,0,0,4,4
RL,0,2,0,0,2
RLGY,0,0,2,4,6
RMD,0,0,0,1,1
RNGR,0,0,0,1,1
RNLSY,0,0,1,0,1
RNSIX,0,0,1,0,1
ROG,0,0,3,1,4
ROK,0,0,2,7,9
ROKU,0,1,16,11,28
ROL,0,1,1,0,2
ROLL,0,1,1,1,3
ROP,0,0,18,7,25
ROST,0,1,5,1,7
RP,0,0,2,3,5
RPBAX,0,0,0,1,1
RPD,0,0,4,0,4
RPM,0,0,4,3,7
RQI,0,0,2,0,2
RSG,0,0,5,2,7
RTN,0,0,3,0,3
RTNB,0,1,0,0,1
RTX,0,0,16,10,26
RUN,0,0,93,0,93
RUSHA,0,0,2,0,2
RWEOY,0,0,1,0,1
RXN,0,0,2,0,2
RXT,0,0,6,3,9
RY.TO,0,0,0,1,1
RYCEY,0,0,1,0,1
SABR,0,0,5,3,8
SAIC,0,0,3,3,6
SAM,0,0,1,2,3
SAN,0,0,1,0,1
SANM,0,0,1,0,1
SAP,0,3,3,5,11
SAVE,0,2,0,0,2
SBAC,0,0,2,5,7
SBCF,0,0,5,0,5
SBGSY,0,0,3,2,5
SBUX,0,0,32,20,52
SC,0,0,0,1,1
SCGLY,0,0,2,0,2
SCHD,0,0,1,1,2
SCHH,0,0,0,1,1
SCHN,0,1,0,0,1
SCHW,0,0,20,8,28
SCI,0,0,6,8,14
SCU,0,0,0,4,4
SCZ,0,0,1,0,1
SDC,0,0,1,0,1
SDOG,0,0,1,0,1
SDXAY,0,0,1,0,1
SDY,0,1,8,0,9
SE,0,0,1,2,3
SEA,0,0,1,2,3
SEDG,0,0,3,0,3
SEE,0,2,4,1,7
SEIC,0,1,2,0,3
SEK,0,0,0,1,1
SERV,0,0,1,0,1
SF,0,0,1,1,2
SFE,0,0,0,12,12
SFST,0,0,1,0,1
SFTBY,0,0,3,3,6
SFY,0,0,0,1,1
SGAPY,0,0,1,0,1
SGEN,0,1,3,0,4
SGIIX,0,0,0,1,1
SGIOY,0,0,4,2,6
SGSOY,0,3,2,2,7
SH,0,1,34,0,35
SHAK,0,2,0,1,3
SHLX,0,0,13,23,36
SHOP,0,0,1,2,3
SHW,0,1,8,7,16
SHYF,0,0,1,0,1
SIRI,0,0,3,4,7
SITC,0,2,0,0,2
SITE,0,3,7,1,11
SIVB,0,0,0,3,3
SJM,0,2,3,1,6
SKFRY,0,0,1,0,1
SKIN,0,0,0,2,2
SKVKY,0,0,2,0,2
SKX,0,0,5,0,5
SKY,0,0,2,2,4
SKYY,0,0,5,0,5
SLAB,0,0,1,1,2
SLB,0,4,10,4,18
SLG,0,0,1,0,1
SLGN,0,0,5,0,5
SLV,0,0,1,3,4
SLVM,0,0,0,5,5
SLYG,0,0,0,1,1
SLYV,0,0,0,1,1
SMFG,0,0,1,0,1
SMFKY,0,0,0,1,1
SMG,0,0,2,0,2
SMHLX,0,0,0,1,1
SMJ,0,1,0,0,1
SMLP,0,0,7,0,7
SMMNY,0,0,1,0,1
SMNNY,0,0,1,0,1
SNA,0,0,1,0,1
SNAP,0,1,3,22,26
SNE,0,0,16,0,16
SNN,0,0,0,2,2
SNNUF,0,0,1,0,1
SNOW,0,0,2,0,2
SNOXX,0,0,5,0,5
SNP,0,0,1,0,1
SNPS,0,0,1,2,3
SNV,0,0,2,4,6
SNX,0,0,1,0,1
SNY,0,0,1,0,1
SO,0,1,27,3,31
SOMMY,0,0,1,0,1
SON,0,0,0,2,2
SONVY,0,1,3,3,7
SONY,0,0,0,3,3
SPCE,0,0,12,8,20
SPDR,0,0,0,1,1
SPDW,0,0,1,1,2
SPG,0,1,8,10,19
SPGI,0,1,9,10,20
SPH,0,0,12,2,14
SPKE,0,0,1,0,1
SPLK,0,1,9,4,14
SPN,0,1,0,0,1
SPOT,0,0,2,7,9
SPR,0,3,0,0,3
SPSC,0,1,2,0,3
SPTI,0,0,0,1,1
SPTM,0,0,1,0,1
SPXC,0,0,1,4,5
SPY,0,1,7,4,12
SPYG,0,0,1,1,2
SPYS,0,0,0,1,1
SPYV,0,0,0,2,2
SQ,0,1,12,14,27
SRC,0,2,0,0,2
SRE,0,2,3,0,5
SRLN,0,0,1,1,2
SRLP,0,0,11,2,13
SRNE,0,0,1,1,2
SRPT,0,1,3,0,4
SSB,0,0,1,3,4
SSL,0,2,3,0,5
SSMXY,0,1,2,2,5
SSNC,0,6,10,3,19
SSREY,0,0,1,0,1
SSUMY,0,0,1,0,1
ST,0,0,0,1,1
STAG,0,0,2,0,2
STAY,0,0,5,1,6
STE,0,1,1,0,2
STLA,0,0,0,4,4
STM,0,0,0,4,4
STOR,0,1,5,2,8
STT,0,0,7,4,11
STWD,0,0,1,0,1
STX,0,1,0,2,3
STXAX,0,0,0,1,1
STZ,0,3,3,3,9
SU,0,2,4,2,8
SUHJY,0,0,1,0,1
SUPN,0,0,4,0,4
SVC,0,0,1,1,2
SVCBY,0,0,1,0,1
SVNDY,0,0,1,0,1
SVNLY,0,0,2,0,2
SWDBY,0,0,1,0,1
SWGAY,0,0,1,0,1
SWK,0,0,7,7,14
SWMAY,0,0,1,0,1
SWN,0,0,1,0,1
SWRAY,0,0,2,0,2
SXYAY,0,0,1,0,1
SYF,0,0,4,4,8
SYIEY,0,1,2,1,4
SYK,0,1,4,6,11
SYNH,0,0,1,2,3
SYPR,0,0,1,0,1
SYY,0,1,13,3,17
SZEVY,0,0,1,0,1
T,0,1,28,32,61
TAP,0,0,4,2,6
TBBC,0,0,0,1,1
TBCIX,0,0,1,0,1
TCBI,0,0,1,0,1
TCEHY,0,2,3,8,13
TCMD,0,1,0,0,1
TCOM,0,1,3,0,4
TDADX,0,0,1,0,1
TDC,0,0,0,1,1
TDDC,0,0,0,1,1
TDDXX,0,5,84,28,117
TDG,0,0,6,1,7
TDOC,0,1,13,4,18
TDXX,0,0,0,1,1
TDY,0,0,4,1,5
TEAM,0,0,6,0,6
TECH,0,0,1,0,1
TEF,0,0,2,0,2
TEL,0,1,4,0,5
TELL,0,0,0,1,1
TER,0,2,0,3,5
TEVA,0,0,2,0,2
TEX,0,0,0,1,1
TEZNY,0,0,1,0,1
TF,0,0,2,0,2
TFC,0,1,11,7,19
TFDXX,0,0,0,5,5
TFFP,0,0,1,0,1
TFX,0,0,5,1,6
TGNA,0,1,2,2,5
TGT,0,1,15,3,19
TGTX,0,0,1,0,1
THR,0,0,3,0,3
TIF,0,0,0,1,1
TIIAY,0,0,1,0,1
TIP,0,0,0,9,9
TJX,0,1,26,12,39
TKC,0,0,0,1,1
TKOMY,0,0,0,1,1
TLND,0,0,1,0,1
TLRY,0,0,2,4,6
TLSNY,0,0,2,0,2
TLSYY,0,0,1,0,1
TLT,0,0,1,0,1
TM,0,0,2,0,2
TME,0,0,1,0,1
TMHC,0,2,0,0,2
TMK,0,1,0,0,1
TMO,0,3,16,13,32
TMSNY,0,1,1,0,2
TMUS,0,0,11,10,21
TMUSR,0,0,2,0,2
TNC,0,0,0,1,1
TNL,0,0,0,1,1
TOL,0,3,3,2,8
TOT,0,1,3,0,4
TPCO,0,0,0,2,2
TPR,0,1,0,6,7
TPX,0,1,0,0,1
TRBCX,0,0,0,1,1
TRGIX,0,0,0,1,1
TRGP,0,0,4,0,4
TRHC,0,1,0,0,1
TRIP,0,2,0,0,2
TRMB,0,1,0,0,1
TRMK,0,1,0,0,1
TRN,0,0,0,4,4
TRNO,0,1,8,0,9
TROW,0,0,2,1,3
TRP,0,1,0,0,1
TRREX,0,0,1,0,1
TRU,0,0,1,3,4
TRUP,0,0,5,4,9
TRV,0,0,4,8,12
TRYIY,0,0,1,0,1
TS,0,1,1,0,2
TSBRX,0,0,0,1,1
TSCDF,0,0,0,1,1
TSCDY,0,0,1,0,1
TSCO,0,0,4,2,6
TSLA,0,1,25,53,79
TSM,0,3,13,14,30
TSN,0,0,3,0,3
TSS,0,1,0,0,1
TT,0,0,6,9,15
TTD,0,0,2,0,2
TTEK,0,0,1,3,4
TTWO,0,0,1,0,1
TWLO,0,0,0,2,2
TWNK,0,0,1,0,1
TWO,0,1,0,0,1
TWST,0,0,1,0,1
TWTR,0,3,7,13,23
TXN,0,0,11,13,24
TXRH,0,2,0,0,2
TYG,0,0,0,1,1
TYL,0,0,0,1,1
UA,0,0,1,2,3
UAA,0,0,4,2,6
UAL,0,0,2,8,10
UBER,0,0,12,9,21
UBS,0,1,8,5,14
UBSI,0,4,5,0,9
UDR,0,0,1,0,1
UFPI,0,0,0,1,1
UHG,0,1,0,3,4
UHS,0,0,1,0,1
UL,0,1,15,4,20
ULTA,0,0,2,1,3
UMPQ,0,4,0,0,4
UN,0,0,0,1,1
UNF,0,0,1,0,1
UNH,0,5,24,11,40
UNICY,0,6,1,1,8
UNM,0,0,1,0,1
UNP,0,1,10,5,16
UNVR,0,0,1,1,2
UPLD,0,0,3,0,3
UPS,0,0,8,10,18
URGO,0,0,0,2,2
URI,0,0,3,1,4
USAC,0,0,23,22,45
USB,0,3,15,7,25
USDP,0,0,11,4,15
USFD,0,0,12,1,13
USMC,0,0,9,0,9
USMV,0,0,1,0,1
USO,0,0,4,0,4
USPH,0,1,0,0,1
UTG,0,0,2,0,2
UTGN,0,1,0,0,1
UTHR,0,1,0,0,1
UTX,0,2,6,0,8
UVV,0,1,0,0,1
V,0,2,29,31,62
VAC,0,0,1,0,1
VAIAF,0,0,0,1,1
VALE,0,0,1,0,1
VAR,0,0,1,2,3
VAW,0,0,2,0,2
VC,0,0,1,0,1
VCRA,0,2,0,0,2
VCSH,0,1,0,0,1
VCYT,0,3,5,0,8
VDC,0,0,10,0,10
VEA,0,1,2,2,5
VEEV,0,0,5,2,7
VEU,0,0,0,1,1
VFC,0,2,3,2,7
VFC.VI,0,0,0,2,2
VFF,0,0,1,0,1
VGPBF,0,0,1,0,1
VGT,0,1,0,0,1
VIAB,0,1,0,0,1
VIAC,0,1,6,17,24
VIASP,0,0,0,1,1
VIAV,0,0,6,0,6
VICI,0,0,0,4,4
VIG,0,2,14,0,16
VIOT,0,1,0,0,1
VIV,0,0,0,1,1
VIVO,0,0,1,1,2
VLO,0,0,5,1,6
VLUE,0,0,1,0,1
VMC,0,0,2,3,5
VMCXX,0,0,0,1,1
VMN,0,0,0,1,1
VMW,0,0,1,3,4
VNO,0,1,4,1,6
VNQ,0,0,0,1,1
VNT,0,0,2,4,6
VOD,0,0,2,0,2
VONE,0,0,1,0,1
VONOY,0,0,1,0,1
VOO,0,0,1,1,2
VOPKY,0,0,2,0,2
VOX,0,0,0,1,1
VPU,0,1,10,0,11
VRM,0,0,0,7,7
VRNS,0,1,0,0,1
VRNT,0,0,1,0,1
VRSK,0,0,8,4,12
VRSN,0,0,2,3,5
VRT,0,0,4,2,6
VRTU,0,0,4,0,4
VRTX,0,2,2,1,5
VSAT,0,0,12,0,12
VSCO,0,0,0,1,1
VSLR,0,0,18,0,18
VTI,0,0,1,0,1
VTR,0,1,6,0,7
VTRA,0,0,0,1,1
VTRS,0,0,5,7,12
VUG,0,0,1,0,1
VUL.V,0,0,0,1,1
VUZI,0,0,0,7,7
VV,0,0,1,0,1
VVNT,0,0,0,1,1
VWDRY,0,0,1,0,1
VWIGX,0,0,0,1,1
VWO,0,0,1,0,1
VXX,0,0,2,2,4
VZ,0,3,16,20,39
W,0,0,1,16,17
WAB,0,0,3,2,5
WAFD,0,2,0,0,2
WAIR,0,0,0,1,1
WAT,0,0,0,1,1
WB,0,3,0,0,3
WB2.SG,0,0,0,2,2
WBA,0,1,8,6,15
WBK,0,0,2,1,3
WBS,0,0,5,0,5
WCAGY,0,0,1,0,1
WCC,0,0,3,2,5
WCG,0,0,1,0,1
WCLD,0,0,0,1,1
WCMIX,0,0,2,0,2
WCN,0,0,3,0,3
WDAY,0,0,2,1,3
WDC,0,1,6,0,7
WDFC,0,1,3,0,4
WDR,0,1,0,0,1
WEC,0,0,1,3,4
WELL,0,0,2,0,2
WES,0,0,10,0,10
WFAFY,0,0,1,0,1
WFC,0,6,29,6,41
WFC$V,0,0,2,0,2
WH,0,2,5,2,9
WHR,0,0,1,1,2
WING,0,1,0,0,1
WIX,0,0,2,0,2
WJRYY,0,0,1,0,1
WK,0,0,1,0,1
WLK,0,0,4,2,6
WLTL,0,0,0,1,1
WLTW,0,0,0,5,5
WM,0,1,10,1,12
WMB,0,0,8,5,13
WMC,0,0,0,1,1
WMGI,0,1,2,0,3
WMT,0,3,10,20,33
WOLWF,0,0,0,1,1
WOPEY,0,0,1,0,1
WORK,0,0,2,2,4
WPC,0,2,2,0,4
WPP,0,0,1,0,1
WPX,0,0,2,0,2
WRK,0,0,7,2,9
WRK.V,0,0,0,1,1
WSC,0,0,2,2,4
WSM,0,0,0,3,3
WSO,0,0,4,0,4
WST,0,1,1,0,2
WSTL,0,0,4,0,4
WTFC,0,0,1,0,1
WTRG,0,0,2,0,2
WTS,0,1,0,0,1
WW,0,0,3,0,3
WWD,0,0,4,2,6
WXA.F,0,0,1,0,1
WY,0,1,1,4,6
WYND,0,3,0,1,4
WYNN,0,0,0,21,21
XEC,0,0,1,1,2
XEL,0,0,3,1,4
XENT,0,1,0,0,1
XHB,0,0,1,0,1
XLB,0,0,1,1,2
XLC,0,0,1,0,1
XLF,0,0,1,2,3
XLI,0,0,1,0,1
XLK,0,0,2,0,2
XLM-USD,0,0,0,2,2
XLNX,0,0,3,0,3
XLV,0,0,2,0,2
XLY,0,0,0,1,1
XMO,0,0,1,0,1
XNGSY,0,0,0,3,3
XOM,0,4,33,19,56
XP,0,0,0,2,2
XPO,0,0,1,1,2
XRAY,0,0,0,3,3
XSOE,0,0,1,0,1
XYL,0,0,3,2,5
YACKX,0,0,0,1,1
YETI,0,2,2,2,6
YEXT,0,3,0,0,3
YNDX,0,1,4,1,6
YTRA,0,0,0,1,1
YUM,0,0,2,0,2
YUMC,0,0,3,0,3
Z,0,0,5,18,23
ZBH,0,0,5,4,9
ZBRA,0,3,9,0,12
ZEN,0,2,0,0,2
ZG,0,0,0,1,1
ZION,0,1,1,0,2
ZM,0,0,2,11,13
ZNGA,0,0,0,3,3
ZOOM,0,0,0,3,3
ZTS,0,2,6,3,11
ZUO,0,1,3,0,4
